10
1111111111
1000F00001
1000011001
1111011001
1110000101
1110011001
1110000001
1001101111
10000000S1
1111111111